111111111111
212002000001
100002200000
122222111111
222222222221
111111111111